t1w	T1w	anat
t2w	T2w	anat
t1rho	T1rho	anat
t1map	T1map	anat
t2map	T2map	anat
t2star	T2star	anat
flair	FLAIR	anat
pd	PD	anat
pdmap	PDmap	anat
pdt2	PDT2	anat
inplanet1	inplaneT1	anat
inplanet2	inplaneT2	anat
angio	angio	anat
bold	bold	func
bold_events	events	func
physio	physio	physio
stim	stim	physio
dwi	dwi	dwi
asl	ASL	perf
asl_m0scan	M0scan	perf
asl_context	aslcontext	perf
asl_labeling	asllabeling	perf
phasediff	phasediff	fmap
magnitude1	magnitude1	fmap
magnitude2	magnitude2	fmap
phase1	phase1	fmap
phase2	phase2	fmap
fieldmap	fieldmap	fmap
epi	epi	fmap
meg	meg	meg
meg_channels	channels	meg
meg_events	events	meg
meg_photo	photo	meg
meg_fid	fid	meg
meg_fidinfo	fidinfo	meg
meg_headshape	headshape	meg
eeg	eeg	eeg
eeg_channels	channels	eeg
eeg_events	events	eeg
eeg_electrodes	electrodes	eeg
eeg_coordsystem	coordsystem	eeg
eeg_photo	photo	eeg
ieeg	ieeg	ieeg
ieeg_channels	channels	ieeg
ieeg_events	events	ieeg
ieeg_electrodes	electrodes	ieeg
ieeg_coordsystem	coordsystem	ieeg
ieeg_photo	photo	ieeg
pet	pet	pet
pet_blood	blood	pet
beh	beh	beh
beh_events	events	beh